"Altersgruppe";"männlich";"weiblich";"divers";"unbekannt";"Todesfälle insgesamt"
"0-9";0;0;0;0;0
"'10-19";1;0;0;0;1
"20-29";3;2;0;0;5
"30-39";3;2;0;0;5
"40-49";12;4;0;0;16
"50-59";69;29;0;0;98
"60-69";191;76;0;0;267
"70-79";442;246;0;0;688
"80-89";574;593;0;0;1167
"90-99";133;275;0;0;408
"100+";0;7;0;0;7
"Unbekannt";0;0;0;0;0
"Gesamt";1428;1234;0;0;2662
