"Altersgruppe";"männlich";"weiblich";"divers";"unbekannt";"Todesfälle insgesamt"
"0-9";0;0;0;0;0
"'10-19";1;0;0;0;1
"20-29";3;2;0;0;5
"30-39";1;2;0;0;3
"40-49";9;4;0;0;13
"50-59";54;22;0;0;76
"60-69";168;61;0;0;229
"70-79";371;206;0;1;578
"80-89";500;516;0;0;1016
"90-99";114;210;0;0;324
"100+";0;5;0;0;5
"Unbekannt";0;0;0;0;0
"Gesamt";1221;1028;0;1;2250
