"Altersgruppe";"männlich";"weiblich";"divers";"unbekannt";"Todesfälle insgesamt"
"0-9";0;0;0;0;0
"'10-19";1;0;0;0;1
"20-29";2;2;0;0;4
"30-39";1;2;0;0;3
"40-49";7;4;0;0;11
"50-59";52;19;0;0;71
"60-69";139;51;0;0;190
"70-79";330;177;0;2;509
"80-89";425;453;0;0;878
"90-99";99;176;0;0;275
"100+";0;4;0;0;4
"Unbekannt";1;3;0;0;4
"Gesamt";1057;891;0;2;1950
