"Altersgruppe";"männlich";"weiblich";"divers";"unbekannt";"Todesfälle insgesamt"
"0-9";0;0;0;0;0
"'10-19";0;0;0;0;0
"20-29";2;1;0;0;3
"30-39";0;1;0;0;1
"40-49";7;2;0;0;9
"50-59";30;16;0;0;46
"60-69";110;36;0;0;146
"70-79";256;128;0;0;384
"80-89";323;330;0;0;653
"90-99";72;127;0;0;199
"100+";0;1;0;0;1
"Unbekannt";1;0;0;0;1
"Gesamt";801;642;0;0;1443
