"Altersgruppe";"männlich";"weiblich";"divers";"unbekannt";"Todesfälle insgesamt"
"0-9";0;1;0;0;1
"'10-19";1;0;0;0;1
"20-29";4;3;0;0;7
"30-39";8;3;0;0;11
"40-49";24;9;0;0;33
"50-59";150;61;0;0;211
"60-69";415;176;0;1;592
"70-79";1089;643;0;3;1735
"80-89";1627;1792;1;11;3431
"90-99";437;909;0;7;1353
"100+";1;20;0;0;21
"Unbekannt";2;0;0;0;2
"Gesamt";3758;3617;1;22;7398
