"Altersgruppe";"männlich";"weiblich";"divers";"unbekannt";"Todesfälle insgesamt"
"0-9";0;1;0;0;1
"'10-19";1;0;0;0;1
"20-29";5;3;0;0;8
"30-39";8;3;0;0;11
"40-49";25;9;0;0;34
"50-59";171;66;0;0;237
"60-69";457;199;0;1;657
"70-79";1197;704;0;5;1906
"80-89";1813;2008;1;15;3837
"90-99";493;1039;0;7;1539
"100+";1;23;0;0;24
"Unbekannt";2;0;0;0;2
"Gesamt";4173;4055;1;28;8257
