"Altersgruppe";"männlich";"weiblich";"divers";"unbekannt";"Todesfälle insgesamt"
"0-9";0;3;0;0;3
"'10-19";1;1;0;0;2
"20-29";10;4;0;0;14
"30-39";22;11;0;0;33
"40-49";70;35;0;0;105
"50-59";413;157;0;1;571
"60-69";939;428;0;9;1376
"70-79";2228;1342;1;15;3586
"80-89";3208;3534;1;36;6779
"90-99";861;1858;1;23;2743
"100+";6;44;0;0;50
"Unbekannt";0;0;0;0;0
"Gesamt";7758;7417;3;84;15262
